/----------------------------------\
|   00                             |
| 00                               |
|     000                          |
|     000                          |
|     000                          |
|     000                          |
|     000                          |
|     000                          |
|     000                          |
\__________________________________/